Camping	camping, #camping
Canyoning	canyoning, #canyoning
Geocaching	geocaching, #geocaching
Orienteering	orienteering, #orienteering
Golf	golf, #golf
Rock climbing	rock climbing, #rockclimbing
Running	running, #running
Alpine skiing	skiing, #skiing
Snowkiting	snowkiting, #snowkiting
Snowmobiling	snowmobiling, #snowmobiling
Agritourism	agritourism, #agritourism, woofing, #woofing
Birding	birding, #birding, bird watching, #birdwatching
Food	#food, food, #foodlover
Horseback riding	horseback riding, #horsebackriding
Hot air balloons	hot air balloon, #hotairballoon
Photography	photography, #photography
Quad bikes	quad bikes, #quadbikes
Scuba diving	scuba diving, #scubadiving
Wine Tourism	wine, #wine
Zip lining	zip lining, #ziplining
Music	music, #music
Historical	historical, #historical
Art	art, #art
Beach	beach, #beach
Shopping	shopping, #shopping
Party	celebrate, celebration, #party
Bead shopping	bead shopping, #beadshopping
Cycling	cycling, #cycling
Recreational shooting	shooting, #shooting
River Rafting	river rafting, #riverrafting
Rock climbing	rock climbing, #rockclimbing
Skydiving	sky diving, #skydiving
Swimming	swimming, #swimming
Windsurfing	wind surfing, #windsurfing
Archery	archery, #archery
Abseiling	abseiling, #abseiling
Safari	safari, #safari
Canoeing	canoeing, #canoeing
Fishing	fishing, #fishing
Treeking	trekking, #trekking
Ice skating	ice skating, #iceskating
Jet skiing	jet boating, jet skiing, #jetboating, #jetskiing
Kayaking	kayaking, #kayaking
Martial arts	martial arts, #martialarts
Mountain biking	mountain biking, #mountainbiking
Paint balling	paintball, #paintball
Parasailing	parasailing, #parasailing
Snorkeling	snorkeling, #snorkeling
Surfing	surfing, #surfing
Rowing	rowing, #rowing
Sailing	sailing, #sailing
Swimming	swimming, #swimming
Yachting	yachting, #yachting

